
NO ./img/colorstone.xpm
EA ./img/greystone.xpm
WE ./img/mossy.xpm
SO ./img/bluestone.xpm

   F 0,64,0


   C 0,204,255

11111111111
10000000001
10111111111
101
1011 1  1111111111111111111111111
1001 1  1000000000110000000000001	11111
1111 1  1011000001110000000000001	10001
        1001000000000000000000001	11111
111111111011000001110000000000001
100000000011000001110111111111111
11110111111111011100000010001
111101111111111011101010000001
11000000110101011100000010001
10000000000000001100000010001
10000000000000001101010010N01
110000011101010111110111100111
11110111 1110101 101111010101
11111111 1111111 111111111 11
1
      



