
NO ./img/colorstone.xpm
   C 0, 204,    255
WE ./img/mossy.xpm
SO ./img/bluestone.xpm

   F 0,     64      ,0

EA ./img/greystone.xpm

11111111111
10000000001
10111111111
101
1011 1  1111111111111111111111111
1001 1  1000000000110000000000001	11111
1111 1  1011000001110000000000001	10001
        1001000000000000000000001	11111
111111111011000001110000000000001
100000000011000001110111111111111
11110111111111011100000010001
11110111111111101110101000N001          111
11000000110101011100000010001           10011111
10000000000000001100000010001           10111111
10000000000000001101010010001            1     111
110000011101010111110111100111
11110111 1110101 101111010101
11111111 1111011 111111111 11
111111111111111
                     11111111
                 111
